____G__X
___XXX__
X___G__X
__XXXX__
___X____
__S__X__